101111111111111111111111111111111111111111111111111111111
100000101000001000000000001000000000000000000000000010001
111110101010111011111110101111111011111111111111111010101
101000100010000010000000100000001010001000100000100010101
101011111110111110111111111111101010101011101010101110101
101000000010000010100010001010001000101000001010100010101
101111111011111110101010101010111111101011111010111010101
100000001000001000101000101010100000001010001010001000101
111011111111101011101111101010101111111010101011101111101
100010000000100010001000100010100000101010100010100010001
101110111110111110111010111010111110101010111110111010111
100010100010000010100010000010000010100010100000000010001
111010101110111010101111111111111010101110101111111111101
100010001000101000101000001000101000100010101000000000001
101110111011101111101110101010101111111010111011111111111
101000100010000000100000100010100000001010000010001000001
101011101111101111111111111110111010111011111110101010101
100000101000001000000000100010100010100010000000101010101
101111101011111011111010101010101011101110111110111010111
100010001000000010100010101000101010001000100010100010001
111110111111111010101111101111101010111011101010101111101
100010100010001000101000001000001010101000001010000010001
101010101010101111101011111011111010101110111111111010111
101000101000100000101000100010100010100000100000101010001
101111101111111110101110111010101110111111101110101011101
101000001000000010100010001010000010000000001000100000101
101111101011101110101011101010111111111111111011111110101
100000101000100000001000100010100000000000001010000010101
101110101110111111111111111110101110101111111010111010101
100010100010001000001000000000101010101000001000100010101
111010111011111011101011111111101010111011101111101111101
100010001000000010100010001000001010001000100000100000101
101111101111101110111111101011111011101110111110111110101
101000100000100000001000001010000000101000100010100010101
111010111110111111101011111011101111101011101110101010101
100010000000100000100010000000001000001010100010101010001
101111111110101110111110111111111011111010101010101011101
101000001000101010000010100010001010000010101010101000001
101011101111101011111010101010101010111110101010101111111
100010001000101000001010001010100010100000001010001000001
111110101010101011101010111110111010101111111011111110101
100000101010101010001010100000100010100010000000000010101
101110111010101010101010101111111110111010111111111010101
100010100010001010101010100000000010100010100000001010101
101011101111111010111010111111111010101110101110101010101
101000101000000010100010000010001000101000101000101010101
101110101111111110101111111010111111101011111011101011101
101000100000000000100000000010001000001010001000101000101
101011111111111110111111111110101011111010101110111110101
101000000000001000100000001000101010001000100010000000101
111111111011101011111110101111101010111111111011111110101
100000000010001010000000100000001010000000001000000010101
101110111111111010101110111111111011101110111111101010101
101010100000000010100010100000000000001010100000101010001
101010101111111111111011101111111111111010101110111011101
101000101000000000001000001000100000100000100010000010001
101111101111101111101111111010101110111111101011111110111
100000101000001000101000100010100010001000101000001010001
101110101011111010101010101110111011101010111111101011101
100010000010000010000010001000000010000010000000001000001
101111111111111111111111111111111111111111111111111111111

