101111111111111111111111111111111111111
101000000010000010000000000010000010001
101011111011101011111110111011101110101
100010001000101000100010101000100000101
111111101110101110101010101110101111101
100000100010001010001000100010100000101
101110111011111011111111101110111110101
101010000010000000100000100010001000101
101011111011111011101010111011101111101
101000000000000010001010000000100010001
101011111111111110111011111111111010111
101000100010000010001000000000001010001
101110101010111011101111111111101011101
101010101010101000100000100000101000001
101010111010101011111110101110101111101
101000000010001000000010101010100000001
101111111011101111101110101010111111111
101000100000100010100010100010000000001
101010111111111010111010111111111011101
100010000010000010001010001000001000101
101111111010111110111011101011101111101
101010001010001000100000100010100000101
101010101011101010101110111110111110101
100010101000100010101000000010000000101
111010101010111011101111111110111111101
101010100010100010001000000000100000001
101010111111101110111011111111101111100
100010000010001010001000100000101000001
101111111010111011101110101110101011111
101000001010000010000010001010001010001
101011101011101110111111111011111011101
101010000010001000100000000010001000101
101010111110111010101111101010101110101
101010001000100010101000101000100010101
111011111011101110101011101111111010101
100010000010001000100010001000000010001
101010111110111110111010111111111111101
101010100010000010100010000000100000101
101110111011111011101111111110101110101
100000000000001000000000000010000010001
111111111111111111111111111111111111111