1011111111111111111111111111111111111
1010000000000010000000000000000000101
1010111110111011101111111011111110101
1010100010101000100010001000001000101
1010101010101110111011101111101011101
1010001010100010100000100000101000001
1011111110101110111110111110101111101
1000000010100000001010100010101000001
1111111010111111101010101010101011111
1000001010000010001000001000101010001
1011101010111011101111111110101010101
1010001010001000100010000000101000101
1010101011111010111010111110101111101
1010101000001010001010100010101000101
1110101111101011101010101011101011101
1000100000101010001010101000101010001
1011101111101110111011101110101010111
1010001000100010101000100010101010001
1011111010111010101110111010101011101
1000000010000000100000000010001000001
1111111111111111111111111111111111101