1011111111111111111111111111111
1010001000000000100000000000001
1010101111101110101111111111101
1010100000100010000010000000001
1010111110111111111110111111101
1010000010000000000000100000101
1011111011111111111111101111101
1000000010000000000000001000001
1111111110111111111011101011111
1000001000100000000010001010001
1011101011101111111111111010101
1000101010100000000000000010101
1010111010111111111111111111101
1010000010000010001000100000001
1011111111101010101010111011101
1000100000001000100010100010001
1110101011111111111110101110111
1000101010000000100010101000001
1011101110111110101110101111101
1010000000000010101000101000101
1011111111111110101011101010111
1000100000000000101010000010001
1110101111111111101011111111101
1010001000000000101000100000001
1011111011111110101110101111101
1000100010001000100010100000101
1011101010101011101110111110101
1010001010101000001000100000100
1010111010101111111011101111101
1000001000100000000000001000001
1111111111111111111111111111111